1 13 31
###############################
#p  *  ** *  1 * 2 *  * * *   #
# # # #*# # #*#*# # # #*#*#*# #
#   ***   ***  *      * 2 * * #
# #*# # # #*# # #*#*# # # # #*#
# *  ****  1 **  *  * *  *    #
# #*#*# # # # # # #*# #*# # # #
#*  *  **  *  *   *  *   3    #
# # # # #*# # # #*#*# # # # # #
#* * *** **  1  * *  *  *   * #
# #*# # # # # # #*# # # # # #*#
#   3  * *  *   *  *  1   **  #
###############################